15 25
_________________________
_________________________
_______XXXXX________X____
___XXXXX___X__XXXX__X____
___X_______XXXX__XXXXXXX_
__XX_______X_____X_____X_
__X________XXXXXXX_____X_
__XXXXXXXX____X__X___XXX_
_____X_XXX____X__X___X___
_____X___X____X__XXXXX___
_____XXX_X____X____X_____
_______XXX____X____X_____
_________X__XXX____X_____
_________XXXX_X____X_____
______________XXXXXX_____
